R 720 480
NO ./textures/colorstone.png
SO ./textures/greystone.xpm
WE ./textures/mossy.xpm

EA ./textures/purplestone.xpm
S ./textures/cagev2.xpm
F 107,73,73
C 104,115,132
        1111111111111111111111111
        1000000000112222222222221
        1011000001112000000000021
        1001000000000000000000021
111111111011000001110222222222221
100000000011000001110111111111111
11110111111111011100000010001
11110111111111011101010010001
11000000110101011100000000001
10022000000000001100000010001
10000002000000001101010010001
11000001110101011111011110N0111
11110111 1110101 101111010001
11111111 1111111 111111111111
