R 1920 1080
NO ./textures/colorstone.png
SO ./textures/greystone.png
WE ./textures/mossy.png
EA ./textures/mossy.png
S ./textures/barrel.png
F 200,200,0
C 0,200,200
11111111111111
10000000000001
10000000001111
10000000001
10000011111
1000001
10000011111
10000000001
11111111111
