R 1920 1080
NO ./textures/colorstone.png
SO ./textures/greystone.png
WE ./textures/mossy.png
EA ./textures/mossy.png
S ./textures/barrel.png
F 200,200,0
C 0,200,200
1 1 1 1 1 1 1 1 1 1 1 1 1 1
1 0 0 0 0 0 0 0 0 0 0 0 0 1
1 0 0 0 0 0 0 0 0 0 1 1 1 1
1 0 0 0 0 0 0 0 0 0 1
1 0 0 0 0 0 1 1 1 1 1
1 0 0 0 0 0 1
1 0 0 0 0 0 1 1 1 1 1
1 0 0 0 0 0 0 0 0 0 1
1 1 1 1 1 1 1 1 1 1 1
