




R 1920 1080



NO ./textures/cagev2.xpm



SO ./textures/cagev2.xpm



WE ./textures/cagev2.xpm

EA ./textures/cagev2.xpm




S ./textures/cagev2.xpm




F 220,100,0




C 225,30,0





        1111111111111111111111111111111111111111111111111111111111111
        1000000000112222222222222222222222222222222222222222222222221
        1011000001112222222222222222222222222222222222222222222222221
        1001000000000000000000000000000000000000000022222222222222221
111111111011000001112222222222222222222222222222222222222222222222221
100000000011000001110111111111111111111111111111111111111111111111111
11110111111111011100000010001
11110111111111011101010010001
11000000110101011100000000001
10002000000000001100000010001
10000000000000001101010010001
11000001110101011111011110N0011
11110111 1110101 101111010001
11111111 1111111 111111111111
