R 1920 1080
NO ./textures/colorstone.png
SO ./textures/greystone.png
WE ./textures/mossy.png

EA ./textures/mossy.png
S ./textures/barrel.png
F 220,100,0
C 225,30,0
1000000000110000000000001
1011000001110000000020001
1001000000000000000000001
111111111011000001110000000000001
100020000011000001110111111111111
11110111111111011100000010001
11110111111111011101010010201
11000000110101011100000010001
10000000000000001100000010001
10000000000000001101010010001
11000001110101011111011110N0111
11110111111101011101111010001
11111111111111111111111111111
