NO ./textures/colorstone.png
SO ./textures/greystone.png
WE ./textures/mossy.png

EA ./textures/mossy.png
S ./textures/barrel.png
R 600 600
F 50,0,0
C 5,9,50

1111111111111111101111111
1000000000110000000000001
1011000001110000000020001
1001000000000000000000001
111111111011000001110000000000001
100000000011000001110111111111111
11110111111111011100000010000001
11110111111111011101010010200001
11000000110101011100000010010001
10000000000000001100000010000001
10000000000000001101010010200001
11000001110101011111011110N00001
11110111111101011101111010000001
11111111111111111111111111111111
