R 1920 1080
NO ./textures/colorstone.png
SO ./textures/greystone.png
WE ./textures/mossy.png

EA ./textures/mossy.png
S ./textures/barrel.png
F 220,100,0
C 225,30,0
1111111111  111 
1000000001 1101 
100000000111000 
100000000010000 
100000000000000 
110000000000000 
 11000000000S01 
  1111111111011 
           101   
           101   
           101   
           101   
            1    
