R 1920 1080
NO ./textures/bluestone.png
SO ./textures/bluestone.png
WE ./textures/redbrick.png
EA ./textures/redbrick.png
S ./textures/barrel.png
F 255,255,255
C 0,0,0
111111
100001
10N001
100001
100001
111211
10101
10001
10101
11111
