R 720 480
NO ./textures/colorstone.png
SO ./textures/greystone.png
WE ./textures/purplestone.png
EA ./textures/mossy.png
S ./textures/barrel.png
F 0,0,0
C 0,200,200

11111111111111111111111111111
1N00000000000000000000000000S
11111111111111111111111111111
