R 720 480
NO ./textures/colorstone.png
SO ./textures/greystone.png
WE ./textures/purplestone.png
EA ./textures/mossy.png
S ./textures/barrel.png
F 0,100,100
C 0,200,200
a
11111111111111111111111111111
10000000001100000000000000001
10110000011100000020000010001
10010020000000000000000010001
10110000011100000000000010001
10000000001100000111011110001
11110111111111011100000010001
11110111111111011101010010001
11000000110101011100020010001
10002000200000001100020010001
10000000000002001101010010001
11000000110101011111011110N01
11110111111101011111011110001
11111111111111111111111111111
